F 0,135,206
C 99,99,99

NO textures/7itlkhr.xpm
SO textures/zombie.xpm
WE textures/hdskulls.xpm
EA textures/flame.xpm

111111111111111111111111
100000000000000000000001
100000000000000000000001
100000000000000000000001
100000000000000000000001
100000000S00000000000001
100000000000000000000001
100000111D10000101010001
100000D00010000000000001
100000100010000100010001
100000100010000000000001
1000001D1100001010100001
100000000000000000000001
100000000000000000000001
100000000000000000000001
100000000000000000000001
100000000000000000000001
100000000000000000000001
100000000000000000000001
111111D11000000000000001
100100001000000000000001
100000101000000000000001
100100001000000000000001
100111111000000000000001
100000000000000000000001
100000000000000000000001
111111111111111111111111
