F 0,135,206
C 99,99,99

NO textures/flame2.xpm
SO textures/dragon.xpm
WE textures/skull.xpm
EA textures/flame.xpm

1111111111111111111
10W1001001001000001
1011000001000001001
1001001001111101111
1001111000001001001
1000000000000001001
100111111D111001001
1111000000000001011
1000000001000000001
1111111111111111111