F 0,135,206
C 99,99,99

NO textures/flame2.xpm
SO textures/dragon.xpm
WE textures/skull.xpm
EA textures/flame.xpm

1111111111111111111
1001001001001000001
1011000001000001001
1001010011111001111
1001111000001001001
1000S00000000001001
1001111111111001001
1111000010000001011
1000000001000000001
1111111111111111111
