F 76,76,76
C 99,99,99

NO textures/7it2.xpm
SO textures/7it5.xpm
WE textures/7itakhor.xpm
EA textures/7it3.xpm

1111111111111111111
1001001001001000001
1011000001000001001
1001N01001111101111
1001111000001001001
1000000000000001001
1001111111111001001
1111000010000001011
1000000001000000001
1111111111111111111
