F 0,135,206
C 99,99,99

NO textures/7itlkhr.xpm
SO textures/7itlkhr.xpm
WE textures/7itlkhr.xpm
EA textures/7itlkhr.xpm

11111111111111111111111111111111111111111111111111111111111111
10E00000000000000000000000000000000000000000000000000000000001
10000000000000000000000000000000000000000000000000000000000001
10000000000000011111111100000000000000000000000000000000000001
10000000000000000000000100000000000000000000000000000000000001
10000000000000000000000100000000000000000000000000000000000001
10000000000000000000000100000000000000000000000000000000000001
10000000000000000000000100000000000000000000000000000000000001
10000000000000000000000100000000000000000000000000000000000001
10000000000000000000000000000000000000000000000000000000000001
10000000000000000000000000000000000000000000000000000000000001
10000000000000000000000000000000000000000000000000000000000001
11111111111111111111111111111111111111111111111111111111111111
